# - # # # # # # # # # # # # # # # # # # 
# - - - - - - - - - - - - - - - - - # # 
# # # # # - # # - # # - # # # - # - - #
# - # # # - # - - # # - # # - - # - # # 
# - # - - - # # # # # # # # # - # - - # 
# - - - # - - - - # - # # - # - # # # #
# - # # # # - # - - - - - - - - - - - #
# - # # - - - # # # # # # # # # # - # #
# - - - - # - - # # - - - - - - - - # #
# # # # # # # # # # # # # # # # # # - # 



